1.
<< in
111111111A1
10000000001
10101110111
10101000001
11101011101
10001010001
10111011111
10001000101
10101010101
10101010001
111B1111111

>> out
20

2.
<< in
111A1111111
10001000001
11101110111
10000000001
10111011101
10101010001
10101011101
10100010001
11111010101
10000010101
111111111B1

>> out
16
